####################################################################################
##░░░░░░░░░░░░░░░░░░░░░░░░░░░░░░░░░░░░░████░░░░░░░░░░░░░░░░░░░░░░░░░░░░░░░░░░░░░░░##
##░░░░░░░░░░░░░░░░░░░░░░░░░░░░░░░░░░░░░████░░░░░░░░░░░░░░░░░░░░░░░░░░░░░░░░░░░░░░░##
##░░░░░░░░░░░░░░░░░░░░░░░░░░░░░░░░░░░░░████░░░░░░░░░░░░░░░░░░░░░░░░░░░░░░░░░░░░░░░##
##░░░░░░░░░░░░░░░░░░░░░░░░░░░░░░░░░░░░░████░░░░░░░░░░░░░░░░░░░░░░░░░░░░░░░░░░░░░░░##
##░░░░░░░░░░░░░░░░░░░░░░░░░░░░░░░░░░░░░████░░░░░░░░░░░░░░░░░░░░░░░░░░░░░░░░░░░░░░░##
##░░░░░░░░░░░░░░██████████░░░░░░░░░░░░░████░░░░░░░░░░░░░██████████░░░░░░░░░░░░░░░░##
##░░░░░░░░░░░░██████░░██████░░░░░░░░░████████░░░░░░░░░██████░░██████░░░░░░░░░░░░░░##
##░░░░░░░░░░░░████░░░░░░████░░░░░░░░░████████░░░░░░░░░████░░░░░░████░░░░░░░░░░░░░░##
##░░░░░░░░░░░░██░░░░░░░░░░██░░░░░░░░░████████░░░░░░░░░██░░░░░░░░░░██░░░░░░░░░░░░░░##
##░░░░░░░░░░░░████░░░░░░████░░░░░░░░░████████░░░░░░░░░████░░░░░░████░░░░░░░░░░░░░░##
##░░░░░░░░░░░░██████░░██████░░░░░░░░░████████░░░░░░░░░██████░░██████░░░░░░░░░░░░░░##
##░░░░░░░░░░░░░░██████████░░░░░░░░░░░░░████░░░░░░░░░░░░░██████████░░░░░░░░░░░░░░░░##
##░░░░░░░░░░░░░░░░░░░░░░░░░░░░░░░░░░░░░████░░░░░░░░░░░░░░░░░░░░░░░░░░░░░░░░░░░░░░░##
##░░░░░░░░░░░░░░░░░░░░░░░░░░░░░░░░░░░░░████░░░░░░░░░░░░░░░░░░░░░░░░░░░░░░░░░░░░░░░##
##██░░░░░░░░░░░░░░░░░░░░░░░░░░░░░░░░░░░░░░░░░░░░░░░░░░░░░░░░░░░░░░░░░░░░░░░░░░░░██##
##████░░░░░░░░░░░░░░░░░░░░░░░░░░░░░░░░░░░░░░░░░░░░░░░░░░░░░░░░░░░░░░░░░░░░░░░░████##
##██████░░░░░░░░██████████░░░░░░░░░░░░░░░░░░░░░░░░░░░░░░██████████░░░░░░░░░░██████##
##████████████████████████████████████████████████████████████████████████████████##
##████████████████████████████████████████████████████████████████████████████████##
##██████░░░░░░░░██████████░░░░░░░░░░░░░░░░░░░░░░░░░░░░░░██████████░░░░░░░░░░██████##
##████░░░░░░░░░░░░░░░░░░░░░░░░░░░░░░░░░░░░░░░░░░░░░░░░░░░░░░░░░░░░░░░░░░░░░░░░████##
##██░░░░░░░░░░░░░░░░░░░░░░░░░░░░░░░░░░░░░░░░░░░░░░░░░░░░░░░░░░░░░░░░░░░░░░░░░░░░██##
##░░░░░░░░░░░░░░░░░░░░░░░░░░░░░░░░░░░░░████░░░░░░░░░░░░░░░░░░░░░░░░░░░░░░░░░░░░░░░##
##░░░░░░░░░░░░░░░░░░░░░░░░░░░░░░░░░░░░░████░░░░░░░░░░░░░░░░░░░░░░░░░░░░░░░░░░░░░░░##
##░░░░░░░░░░░░░░██████████░░░░░░░░░░░░░████░░░░░░░░░░░░░██████████░░░░░░░░░░░░░░░░##
##░░░░░░░░░░░░██████░░██████░░░░░░░░░████████░░░░░░░░░██████░░██████░░░░░░░░░░░░░░##
##░░░░░░░░░░░░████░░░░░░████░░░░░░░░░████████░░░░░░░░░████░░░░░░████░░░░░░░░░░░░░░##
##░░░░░░░░░░░░██░░░░░░░░░░██░░░░░░░░░████████░░░░░░░░░██░░░░░░░░░░██░░░░░░░░░░░░░░##
##░░░░░░░░░░░░████░░░░░░████░░░░░░░░░████████░░░░░░░░░████░░░░░░████░░░░░░░░░░░░░░##
##░░░░░░░░░░░░██████░░██████░░░░░░░░░████████░░░░░░░░░██████░░██████░░░░░░░░░░░░░░##
##░░░░░░░░░░░░░░██████████░░░░░░░░░░░░░████░░░░░░░░░░░░░██████████░░░░░░░░░░░░░░░░##
##░░░░░░░░░░░░░░░░░░░░░░░░░░░░░░░░░░░░░████░░░░░░░░░░░░░░░░░░░░░░░░░░░░░░░░░░░░░░░##
##░░░░░░░░░░░░░░░░░░░░░░░░░░░░░░░░░░░░░████░░░░░░░░░░░░░░░░░░░░░░░░░░░░░░░░░░░░░░░##
##░░░░░░░░░░░░░░░░░░░░░░░░░░░░░░░░░░░████████░░░░░░░░░░░░░░░░░░░░░░░░░░░░░░░░░░░░░##
##░░░░░░░░░░░░░░░░░░░░░░░░░░░░░░░░░████████████░░░░░░░░░░░░░░░░░░░░░░░░░░░░░░░░░░░##
##░░░░░░░░░░░░░░░░░░░░░░░░░░░░░░░████████████████░░░░░░░░░░░░░░░░░░░░░░░░░░░░░░░░░##
####################################################################################